Gg, Gg, Hh, Hh, Hh, Hh, Hh, Hh, Hh, Gg, Mm, Gg, Gg, Gg, Gg, Gg, Gg, Gg, Hh, Gg, Hh, Hh, Hh, Gg, Hh, Gg, Rb, Gg, Gg, Gg, Gg, Gg, Gg, Gg
Hh, Hh, Hh, Hh, Hh, Hh, Hh, Hh, Gg, Hh, Gg, Mm, Mm, Gg, Gg, Gg, Gg, Hh, Hh, Hh, Gs^Vh, Gg, Gg, Hh, Re, Rb, Gs^Fds, Gs^Fds, Gs^Fds, Gg, Cvr, Cvr, Kvr, Gg
Hh, Hh, Hh, Hh, Gg, Hh, Gg, Gg, Gg, Gg, Gs^Fms, Gs^Fms, Mm, Mm, Mm, Mm, Gg, Hh, Gg, Gg^Efm, Gg^Efm, Gg^Efm, Re, Re, Rb, Gs^Fds, Cvr, Cvr, Cvr, Cvr, Gs^Fds, Cvr, Gs^Fds, Gg
Hh, Hh, Gg, Gg, Gg, Gg, Rp^Vhcr, Gg, Gs^Fms, Gs^Fms, Gs^Fms, Gs^Fms, Gs^Fms, Mm, Gg, Gg, Gg, Gg, Gg, Gg, Gg^Ii, Gg^Ii, Re, Rb^Edb, Rb, Rb, Rb, Cvr, Gg, Gg, Gs^Fds, Gs^Fds, Gg, Gg
Gg, Gg, Gg, Gg, Gg, Gg, Gg^Efm, Gs^Fms, Gs^Fms, Gs^Fms, Gs^Fms, Gs^Fms, Gg, Gg, Gg, Gs^Fds, Gs^Fds, Gg, Gg, Gs^Fds, Gs^Fds, Re, Rb, Rb, Rb^Edb, Rb^Edb, Rb, Rb, Rb^Edb, Gg, Gg^Edb, Gg, Gg, Hh
Hh, Gg, Gg, Gg, Gg, Gg^Efm, Gs^Fms, Gs^Fms, Gs^Fms, Gs^Fms, Gs^Fms, Gs^Fms, Rd, Rd, Rd, Rd, Rd, Rd, Rd, Gs^Vh, Rd, Re, Rd, Rb^Edb, Rb, Rb, Rb, Rb^Edb, Rb, Rb^Edb, Rb, Gs^Vh, Hh, Hh
Hh, Hh, Gg, Gg, Gs^Fms, Gs^Fms, Gs^Fms, Gs^Fms, Gs^Fms, Gs^Fms, Gg, Rd, Rd, Rd, Gg, Gg, Gg, Gg, Gg, Rd, Rd, Rd, Rd, Rd, Rd, Rb, Re, Rb, Rb, Rb, Rb, Rb, Hh, Gg
Hh, Hh, Mm, Gs^Fms, Gs^Fms, Gs^Fms, Gs^Fms, Gs^Fms, Gs^Fds, Gs^Fds, Gg, Rd, Gs^Fds, Gs^Fms, Gs^Fms, Gg, Gs^Fms, Gg, Gg, Gg, Gg, Gg, Gg, Gg, Gg, Rd, Rd, Re, Re, Rb, Rd, Hh, Gg, Gg
Hh, Mm, Mm, Gg, Gg, Gs^Fms, Gs^Fds, Gs^Fds, Gg, Gg, Gg, Rd, Gg, Gs^Fds, Gs^Fds, Gs^Fms, Gs^Fds, Gs^Fms, Gs^Fms, Gs^Fms, Gs^Fms, Gs^Fms, Gs^Fms, Gg, Gs^Fds, Gs^Fds, Gs^Fds, Rd, Rd, Re, Rd, Hh, Gg, Gg
Mm, Mm, Gg, Gg, Gg, Gg, Gg, Gg, Gg, Gg, Rd, Rd, Gg, Gs^Fds, Gs^Fds, Gs^Fds, Gs^Fms, Gg, Gs^Vh, Gg, Gg^Efm, Gg, Gs^Fms, Gs^Fms, Gs^Fms, Gs^Fms, Gs^Fms, Gs^Fds, Gg^Efm, Rd, Rd, Hh, Gg, Gg
Mm, Mm, Gg, Gg, Gg, Gg, Gg, Gg, Gg, Gg, Rd, Gg, Gg, Gg, Gs^Fms, Gg^Efm, Rd, Gs^Fms, Gs^Fms, Gs^Fms, Gs^Fms, Gs^Fms, Gg, Gs^Fms, Gs^Fds, Gs^Fms, Gs^Fds, Gs^Fds, Gg, Rd, Gs^Vh, Hh, Gg, Gg
Gg, Gg, Gg, Gg, Gg, Gs^Fms, Gs^Fms, Gg, Gg, Gg, Rd, Rd, Gs^Fms, Gs^Fms, Gs^Fms, Rd, Rd, Rd, Rd, Gg, Rd, Rd, Rd, Rd, Rd, Gs^Fds, Rd, Gg, Rd, Rd, Gg^Efm, Gg, Gg, Gg
Gg, Gg, Gg, Gg, Gg, Gs^Fms, Gs^Fms, Gs^Fms, Rd, Rd, Gs^Fms, Gs^Fms, Gs^Fds, Gs^Vh, Rd, Rd, Gg, Gg, Gg, Rd, Rd, Gg, Gg, Gg, Gg, Rd, Gg, Rd, Gg, Gg, Gg, Gg, Gg, Gg
Gg, Gg, Gg, Gg, Gg, Gs^Fms, Gs^Fms, Gs^Fms, Rd, Gg, Gs^Fds, Gs^Fds, Gg, Rd, Gg, Gg, Gg, Gg, Gs^Fms, Gs^Fms, Rd, Rd, Gg, Gg, Gg, Gg, Gg, Gg, Gg, Gg, Gg, Gg, Gg, Gg
Gg, Gg, Gg, Gg, Gs^Fms, Gs^Fms, Gg, Rd, Gg, Gs^Fds, Gs^Fds, Gs^Fds, Rd, Rd, Gg, Gg, Gs^Fms, Gs^Fms, Gs^Fms, Gs^Fms, Gs^Fms, Rd, Rd, Gg, Gg, Gg, Gg, Gg, Gg, Gg, Mm, Gg, Gg, Gg
Gg, Gg, Gg, Gs^Fms, Gs^Fms, Gs^Fms, Gs^Fms, Rd, Gg, Gg, Gg, Rd, Rd, Gg, Gs^Fds, Gs^Fms, Gs^Fms, Gs^Fms, Gs^Fms, Gs^Fms, Gs^Fms, Gg, Gg, Gs^Vh, Gg, Gg, Gg, Gg, Gg, Gg, Mm, Gg, Gg, Gg
Gg, Gg, Gg, Gg, Gg, Gs^Vh, Gs^Fms, Rd, Rd, Gg, Rd, Rd, Gs^Fds, Gs^Fds, Gs^Fms, Gs^Fms, Gs^Fds, Gs^Fms, Gs^Fms, Gs^Fms, Gs^Fms, Gg^Efm, Gg, Gg, Gg, Gg, Gg, Gg, Gg, Gg, Gg, Mm, Mm, Gg
Gg, Gg, Gg, Gg, Gg, Gs^Fms, Gg, Gg, Gg, Rd, Gg, Gg, Gs^Fms, Gs^Fms, Gs^Fms, Gs^Fds, Gs^Fms, Gs^Fms, Gg^Ii, Gg^Efm, Gg, Gs^Fms, Gs^Fms, Gg, Gg, Gg, Gg, Gg, Gg, Gg, Gg, Mm, Hh, Gg
Rd, Gg, Gg, Gg, Gg, Gg, Gg, Gg, Rd, Rd, Gs^Fms, Gs^Fms, Gg^Efm, Gg, Gs^Fms, Gs^Fms, Gs^Fms, Gg^Ii, Gg^Ii, Gg^Ii, Gs^Fms, Gs^Fms, Gg, Gg, Gg, Gg, Gg, Gg, Gg, Gg, Gg, Hh, Hh, Gg
Rd, Rd, Gg, Gg, Gg, Gg, Gg, Gg, Rrc, Gs^Fms, Gg, Gs^Fms, Gg, Gg, Gs^Fms, Gs^Fms, Gs^Fms, Gs^Fms, Gs^Fms, Gs^Fms, Gg, Gg, Gg, Gg, Gg, Gg, Gg, Gg, Gg^Efm, Gg^Efm, Hh, Hh, Hh, Gg
Gg^Esd, Rd, Rd, Gg, Gg^Esd, Gg, Rr, Rrc, Rrc, Gg, Gg, Gg, Gg, Gs^Fms, Gs^Fms, Gs^Fms, Gs^Fms, Gs^Fms, Gg, Gg, Gg, Gg, Gg, Gg, Gg, Gg, Gg^Efm, Mm, Hh, Hh, Hh, Hh, Hh, Gg
Ww, Gg^Esd, Gg^Esd, Rd, Ch, Rr, Rr, Rr, Rr, Gg^Esd, Gg, Gg, Gg, Gg, Gg, Gg, Gg, Gg, Gg, Gg, Gg, Gg, Gg, Gg, Gg, Gg, Gg, Hh, Hh, Hh, Gg, Gg, Hh, Gg
Wo, Ww, Ww, Kh, Ch, Ch, Ch, Rr, Gg, Gs^Vh, Gg, Gg, Gg, Gg, Gg, Gg, Gg, Gg, Gg, Gg, Gg^Efm, Gg^Efm, Gg^Efm, Gg, Gg, Gg, Gg, Gg, Gg, Gg, Gg, Gg, Hh, Gg
Wo, Wo, Ww, Ch, Ch, Ch, Ch, Rr, Gg^Efm, Gg, Gg, Gg, Gg, Gg, Gg, Gg, Gg, Gg, Gg, Gg, Gg, Hh, Hh, Gg, Gg, Gg, Gg, Gg, Gg, Gg, Gg, Hh, Gg, Gg
Wo, Wo, Wo, Ww, Ww, Ch, Chw, Gg, Gg^Efm, Gg^Efm, Gg^Efm, Gg, Gg^Esd, Gg, Hh, Gg, Mm, Mm, Mm, Mm, Hh, Hh, Hh, Hh, Hh, Gg, Gg, Gg, Gg, Gg, Gg, Gg, Gg, Gg
Wo, Wo, Wo, Ww, Ww, Ww, Ww, Ww, Gg^Gvs, Gg^Efm, Gg, Gg, Gg, Gg^Esd, Gg, Hh, Hh, Hh, Hh, Hh, Gg, Hh, Gg, Hh, Gg, Hh, Gg, Gg, Gg, Gg, Gg, Gg, Gg, Gg
