Ur, Ur, Xoa, Ur, Xoa, Ur, Xoa, Ur, Xoa, Ur, Xoa, Ur, Xoa, Ur, Xoa, Ur, Xoa, Ur, Xoa, Ur, Uu, Uu, Uu, Ur, Ur, Ur, Ur, Ur, Ur, Ur, Ur, Ur, Ur, Gg, Gg, Gg, Gg, Gg
Xoa, Xoa, Ql, Xoa, Ur, Xoa, Ur, Xoa, Xoa, Xoa, Ur, Xoa, Ur, Xoa, Xoa, Xoa, Uu, Xoa, Ur, Xoa, Xoa, Uu, Uu, Ur, Ur, Ur, Ur, Ur, Ur, Ur, Ur, Ur, Ur, Aa, Gg, Gg, Gg, Gg
Xoa, Xoa, Ql, Ql, Ur, Ur, Xoa, Xoa, Xoa, Xoa, Ur, Ur, Ur, Ur, Ur, Xoa, Xoa, Uu, Ur, Ur, Ur, Xoa, Xoa, Ur, Ur, Ur, Ur, Ur, Ur, Ur, Ur, Ur, Ur, Aa, Gg, Gg, Gg, Gg
Xoa, Ql, Exos, Ur, Uu, Uu, Uu, Ur, Ur, Xoa, Xoa, Uu^Vu, Ur, Ur, Ur, Ur, Ur, Xoa, Xoa, Ur, Ur, Ur, Xoa, Ur, Ur, Ur, Gg, Gg, Khs, Ur, Ur, Ur, Ur, Aa, Gg, Gg, Gg, Gg
Xoa, Uu, Koa, Exos, Exos, Iwc, Iwc, Ur, Ur, Ur, Ql, Ql, Ur, Ur, Xoa, Ur, Ur, Ur, Xoa, Ur, Uu, Uu, Xoa, Ur, Ur, Ur, Ch, Ch, Ch, Gg, Gg, Gg, Ur, Gg, Gg, Gg, Gg, Gg
Xoa, Uu, Exos, Exos, Iwc, Iwc, Xoa, Iwc, Ur, Ur, Ur, Ur, Ur, Ur, Ur, Xoa, Ur, Ur, Ur, Ur, Uu, Uu, Xoa, Ur, Ur, Ur, Ch, Ch, Ur, Gg, Ur, Gg, Aa, Gg, Gg, Gg, Gg, Gg
Xoa, Uu, Uu, Exos, Uu, Xoa, Xoa, Xoa, Ur, Ur, Ur, Ur, Ur, Ur, Xoa, Xoa, Ur, Ur, Ur, Ur, Ur, Uu, Xoa, Ur, Ur, Ur, Sm, Sm, Gg, Ur, Gg^Eqf, Aa, Gg, Gg, Gg, Gg, Gg, Gg
Xoa, Uu, Uu, Uu, Uu, Xoa, Xoa, Qxua, Qxua, Ur, Ur, Ur, Xoa, Xoa, Ur, Ur, Ur, Ur, Xoa, Ur, Uu, Uu, Uu, Xoa, Xoa, Sm, Xoa, Xoa, Xot, Gg^Eqf, Gg, Gg, Gg, Gg, Gd^Vo, Gg, Gg^Eqf, Gg^Eqf
Xoa, Uu, Uu, Uu, Uu, Xoa, Xoa, Qxua, Qxua, Qxua, Ur, Ur, Ur, Ur, Ur, Ur, Xoa, Xoa, Ql, Uu, Uu, Uu, Uu, Uu, Xoa, Xoa, Xor, Xor, Gg, Gg, Ur, Gg, Ur^Ebn, Gg, Ur, Gg^Eqf, Ur, Gg
Xoa, Uu, Uu, Uu, Uu, Xoa, Xoa, Qxua, Qxua, Ur, Ur, Ur, Ur, Ur, Xoa, Xoa, Ql, Ql, Uu, Uu, Uu, Uu, Xoa, Qxu^Bp\, Qxu^Bp\, Xor^Exw, Ur, Ur, Ur, Ur, Ur, Ur, Isa^Ii, Isa, Isa^Ebn, Isa, Ur, Ur
Xoa, Uu, Uu, Uu, Uu, Uu, Uu, Xoa, Ur, Ur, Ur, Ur, Ur, Ur, Xoa, Xoa, Uu, Uu, Uu, Uu, Xoa, Xoa, Xor, Xor, Ur, Ur, Ur, Ur, Ur, Gg, Isa^Ii, Isa, Isa, Isa, Ur, Ur, Xor, Xor
Xoa, Uu, Uu, Xoa, Xoa, Uu, Uu, Ur, Uu, Uu, Uu, Ur, Xoa, Xoa, Uu, Uu, Uu, Uu, Xoa, Xoa, Xor, Xor, Ur, Ur, Ur, Ur, Ur, Ur, Isa^Ii, Isa, Isa, Isa, Ur, Ur, Xor, Xor, Xor, Xor
Xoa, Uu, Uu, Ql, Xoa, Ql, Ql, Ur, Uu, Uu^Vu, Uu, Ur, Xoa, Uu, Uu, Uu, Xoa, Xoa, Xor, Xor, Ur, Ur, Ur, Uu^Vud, Ur, Ur, Isa, Isa, Isa, Isa, Ur, Ur, Ur, Ur, Xor, Xor, Gg, Gg
Xoa, Uu, Uu, Ql, Xur, Ql, Xur, Xur, Xur, Uu, Xur, Xur, Xur, Uu, Xur, Xoa, Xor, Xor, Ur, Ur, Ur, Ur, Ur^Ebn, Ur, Isa, Isa^Ii, Isa, Isa, Ur, Ur, Ur, Ur, Xor, Xor, Xor, Xor, Gg, Gg
Xoa, Xoa, Xur, Xur, Xur, Xur, Mm^Xm, Xur, Mm^Xm, Xur, Mm^Xm, Xur, Mm^Xm, Mm, Mm^Xm, Xuc, Ur, Ur, Ur, Ur, Ur, Ur, Isa^Ii, Isa, Isa, Isa, Ur, Ur, Ur, Ur, Xor, Xor, Xor, Xor, Gg, Gg, Gg, Gg
Xur, Xur, Xur, Xur, Mm^Xm, Mm^Xm, Mm, Mm^Xm, Mm, Mm, Mm, Mm, Mm, Mm^Xm, Mm^Xm, Xuc, Xuc, Ur, Ur, Ur, Isa, Isa, Isa, Isa, Ur, Ur^Ebn, Ur, Ur, Xor, Xor, Xor, Xor, Gg, Gg, Gg, Gg, Gg, Gg
Mm^Xm, Mm^Xm, Mm^Xm, Mm^Xm, Mm^Xm, Mm, Mm, Mm, Mm, Mm, Mm, Mm, Mm, Mm, Mm, Mm^Xm, Xuc, Ur, Isa, Isa, Isa, Isa, Xom, Ur, Ur, Ur, Xor, Xor, Xor, Xor, Gg, Gg, Gg, Gg, Gg, Gg, Gg, Gg
Mm, Mm, Mm, Mm, Mm, Mm, Mm, Mm, Mm, Mm, Mm, Mm, Mm, Mm, Mm, Mm, Gg, Ur, Gg, Isa, Mm^Xm, Xuc, Mm^Xm, Xom, Xor, Xor, Mm^Xm, Xor, Gg, Gg, Gg, Gg, Gg, Gg, Gg, Gg, Gg, Gg
Mm, Mm, Mm, Mm, Mm, Mm, Mm, Mm, Gll^Fp, Mm, Hh^Vhh, Mm, Gg, Mm, Gg, Gg, Gg, Gg, Mm, Mm, Mm, Mm^Xm, Mm, Mm^Xm, Mm^Xm, Mm^Xm, Mm^Xm, Mm^Xm, Mm^Xm, Gg, Gg, Gg, Gg, Gg, Gg, Gg, Gg, Gg
Gg, Mm, Gll^Fp, Mm, Gll^Fp, Gll^Fp, Mm, Gll^Fp, Gll^Fp, Gll^Fp, Gg, Gg, Gg, Gg, Gg, Gg, Mm, Mm, Mm, Mm, Mm, Mm, Mm, Mm, Mm, Mm, Mm, Mm, Mm, Mm^Xm, Mm^Xm, Gg, Gg, Gg, Gg, Gg, Gg, Wog
Gg, Gll^Fp, Gll^Fp, Gll^Fp, Gll^Fp, Gll^Fp, Gll^Fp, Gll^Fp, Gg, Gg, Gg, Gg, Gg, Gg, Md, Mm, Md, Md, Md, Mm, Gll^Fp, Mm, Gg, Mm, Cer, Mm, Mm, Mm, Mm, Mm, Mm, Mm^Xm, Gg, Gg, Gg, Gg, Gg, Gg
Gg, Gg, Gg, Gll^Fp, Gll^Fp, Gll^Fp, Cer, Cer, Gg, Gg, Gg, Gg, Gg, Gg, Gg, Md, Md, Md, Gll^Fp, Gll^Fp, Gll^Fp, Gg, Gg, Cer, Cer, Cer, Gg, Mm, Mm, Mm, Mm, Mm^Xm, Gg, Gg, Gg, Gg, Gg, Gg
Gg, Gg, Gg, Gg, Gg, Gg, Gg, Cer, Gg, Gg, Gg, Gg, Gg, Gg, Gg, Gg, Gll^Fp, Gll^Fp, Gll^Fp, Gll^Fp, Hh^Vhh, Gg, Gg, Cer, Gg, Gg, Gg, Gg, Mm, Mm, Mm, Mm^Xm, Md^Xm, Gg, Gg, Gg, Gg, Gg
Gg, Gg, Gg, Gg, Gg, Gg, Gg, Gg, Gg, Gg, Gg, Gg, Gg, Gg, Gg, Gg, Gll^Fp, Gll^Fp, Gg, Gg, Gg, Gg, Gg, Gg, Gll^Fp, Gll^Fp, Gll^Fp, Gll^Fp, Gll^Fp, Mm, Mm, Mm^Xm, Md^Xm, Md^Xm, Gg, Gg, Gg, Gg
Gg, Gg, Gg, Gg, Gg, Gg, Gg, Gg, Gg, Gg, Gg, Gg, Gg, Gg, Gg, Gg, Gg, Gg, Gg, Gg, Gg, Gg, Gg, Gg, Gll^Fp, Gll^Fp, Gll^Fp, Gll^Fp, Gll^Fp, Mm, Mm, Md^Xm, Md^Xm, Md^Xm, Md^Xm, Md^Xm, Md^Xm, Gg
Gg, Gg, Gg, Gg, Gg, Gg, Gg, Gg, Gg, Gg, Gg, Gg, Gg, Gg, Gg, Gg, Gg, Gg, Gg, Gg, Gg, Gg, Gg, Gg, Gg, Gll^Fp, Gll^Fp, Gll^Fp, Gll^Fp, Gll^Fp, Gll^Fp, Gll^Fp, Gll^Fp, Md^Xm, Md^Xm, Md^Xm, Md^Xm, Md^Xm
Gg, Gg, Gg, Gg, Gg, Gg, Gg, Gg, Gg, Gg, Gg, Gg, Gg, Gg, Gg, Gg, Gg, Gg, Gg, Gg, Gg, Gg, Gg, Gg, Gg, Gll^Fp, Gll^Fp, Gll^Fp, Gll^Fp, Gll^Fp, Gll^Fp, Gll^Fp, Gll^Fp, Gll^Fp, Gg, Md^Xm, Md^Xm, Md^Xm
Gg, Gg, Gg, Gg, Gg, Gg, Gg, Gg, Gg, Gg, Gg, Gg, Gg, Gg, Gg, Gg, Gg, Gg, Gg, Gg, Gg, Gg, Gg, Gg, Gg, Gg, Gg, Gll^Fp, Gll^Fp, Gll^Fp, Gll^Fp, Gll^Fp, Gll^Fp, Gll^Fp, Gll^Fp, Gg, Gg, Md^Xm
Gg, Gg, Gg, Gg, Gg, Gg, Gg, Gg, Gg, Gg, Hh^Vhh, Gg, Gg, Gg, Gg, Gg, Gg, Gg, Gg, Gg, Gg, Gg, Gg, Gg, Gg, Gg, Gg, Gg, Gll^Fp, Gll^Fp, Gll^Fp, Gll^Fp, Gll^Fp, Gll^Fp, Gg, Gg, Gg, Gg
Gg, Gg, Gg, Gg, Gg, Gg, Gg, Gg, Gg, Gg, Gg, Gg, Gg, Gg, Gg, Gg, Gg, Gg, Gg, Gg, Gg, Gg, Gg, Gg, Gg, Gg, Gg, Gg, Gll^Fp, Gll^Fp, Gll^Fp, Gll^Fp, Gll^Fp, Gll^Fp, Gg, Gg, Gg, Gg
Gg, Gg, Gg, Gg, Gg, Gg, Gg, Gg, Gg, Gg, Gg, Gg, Gg, Gg, Gg, Gg, Gg, Gg, Gg, Gg, Gg, Gg, Gg, Gg, Gg, Gg, Gg, Gg, Gg, Gll^Fp, Gll^Fp, Gll^Fp, Gll^Fp, Gll^Fp, Gg, Gg, Gg, Gg
Gg, Ket, Ce, Gg, Gg, Gg, Gg, Gg, Gg, Gg, Gg, Gg, Gg, Gg, Gg, Gg, Gg, Gg, Gg, Gg, Gg, Gg, Gg, Gg, Gg, Gg, Gg, Gg, Gg, Gll^Fp, Gll^Fp, Gll^Fp, Gll^Fp, Gll^Fp, Gg, Gg, Gg, Gg
Gg, Ke, Ce, Ce, Ce, Ce, Gg, Gg, Gg, Gg, Gg, Gg, Gg, Gg, Gg, Gg, Gg, Gg, Gg, Gg, Gg, Gg, Gg, Gg, Gg, Gg, Gg, Gg, Gg, Gg, Gg, Gll^Fp, Gll^Fp, Gll^Fp, Gg, Gg, Gg, Gg
Gg, Gg, Gg, Ce, Gg, Gg, Gg, Gg, Gg, Gg, Gg, Gg, Gg, Gg, Gg, Gg, Gg, Gg, Gg, Gg, Gg, Gg, Gg, Gg, Gg, Gg, Gg, Gg, Gg, Gg, Gg, Gg, Gg, Gg, Wog, Gg, Wog, Gg
