Wo, Wo, Wo, Wo, Wo, Wo, Wo, Ww, Ww, Ai, Ai, Ai, Ai, Aa, Aa, Aa, Aa^Fpa, Gs, Ms, Aa^Fpa, Aa, Ai, Ai, Gs, Cva, Cva, Cva, Cva, Cva, Ai, Aa, Aa, Aa^Fpa, Gs, Ms, Gs, Ms, Gg
Wo, Wo, Wo, Wo, Wo, Wo, Ww, Ww, Ww, Wwr, Ai, Ai, Aa, Aa, Aa^Vka, Aa, Aa^Fpa, Ms, Ms, Aa^Fpa, Aa, Aa, Ai, Cva, Cva, Cva, Cva, Cva, Cva, Ai, Aa, Aa, Aa^Fpa, Aa^Fpa, Ms, Ms, Ms, Ms
Wo, Wo, Wo, Wo, Wo, Wo, Ww, Ww, Ww, Wwr, Wwr, Ai, Aa, Aa, Rra, Aa, Aa^Fpa, Ms, Ms, Aa^Fpa, Aa, Aa, Ai, Cva, Cva, Kha, Kha, Cva, Cva, Aa, Aa, Aa, Aa^Fpa, Ms, Ms, Ms, Ms, Ms
Wo, Wo, Wo, Wo, Wo, Wo, Wo, Ww, Ww, Ww, Wwr, Aa, Aa, Rra, Rra, Aa, Aa^Fpa, Ms, Ms, Aa^Fpa, Aa, Ai, Cva, Cva, Cva, Cva, Cva, Cva, Cva, Aa, Aa, Aa, Aa^Fpa, Ms, Ms, Ms, Ms, Ms
Wo, Wo, Wo, Wo, Wo, Wo, Wo, Ww, Ww, Ww, Wwr, Ai, Aa, Rra, Rra, Aa, Aa^Fpa, Ms, Ms, Aa^Fpa, Aa, Ai, Ai, Cva, Cva, Cva, Cva, Cva, Cva, Aa, Ai, Aa, Aa^Fpa, Ms, Ms, Ms, Rra, Rra
Wo, Wo, Wo, Wo, Wo, Wo, Wwr, Ww, Wwr, Wwr, Ai, Ai, Ai, Rra, Aa, Aa, Aa^Fpa, Ms, Ms, Aa^Fpa, Aa, Ai, Aa, Ai, Rra, Cva, Rra, Cva, Ai, Ai, Ai, Aa, Aa^Fpa, Ms, Ms, Ms, Rra, Rra
Wo, Wo, Wo, Wo, Wo, Wwr, Ai, Wwr, Aa^Fma, Ai, Aa^Fma, Ai, Ai, Rra, Aa, Aa^Fpa, Ms, Ms, Ms, Aa^Fpa, Aa, Aa, Ai, Ai, Ai, Rra, Rra, Ai, Ai, Ai, Aa, Aa, Aa^Fpa, Ms, Ms, Ms, Rra, Rra
Wo, Wo, Wo, Wo, Wwr, Wwr, Aa^Vea, Aa^Fma, Rra, Aa^Fma, Rra, Aa^Fma, Ai, Rra, Aa, Aa^Fpa, Ms, Ms, Ms, Aa^Fpa, Aa, Aa^Fma, Aa, Ai, Ai, Rra, Ai, Ai, Ai, Aa, Aa^Voa, Aa, Aa^Fpa, Ms, Ms, Ms, Rra, Ms
Wo, Wo, Wo, Wo, Wwr, Ai, Aa, Rra, Rra, Rra, Aa^Fma, Rra, Rra, Rra, Aa, Aa^Fpa, Ms, Ms, Aa^Fpa, Aa^Fpa, Ai, Aa, Ai, Ai, Rra, Rra, Ai, Ai, Ai, Aa, Aa, Aa, Aa^Fpa, Ms, Ms, Ms, Rra, Ms
Wo, Wo, Wo, Wo, Wwr, Wwr, Ai, Aa^Fma, Aa^Fma, Aa^Fma, Ai, Aa^Fma, Ai, Rra, Rra, Aa^Fpa, Aa^Fpa, Ms, Aa^Fpa, Aa, Ai, Ai, Ai, Ai, Rra, Rra, Aa, Ai, Ai, Ai, Aa, Aa^Fpa, Ms, Ms, Ms, Ms, Rra, Ms
Wo, Wo, Wo, Wo, Wo, Wwr, Wwr, Ai, Wwr, Ai, Ai, Ai, Ai, Ai, Rra, Aa, Aa, Aa^Fpa, Aa, Aa, Aa, Aa, Aa, Aa, Rra, Rra, Aa, Aa, Ai, Ai, Aa, Aa^Fpa, Ms, Ms, Ms, Ms, Rra, Ms
Wo, Wo, Wo, Wo, Wo, Wo, Ww, Wwr, Ww, Wwr, Wwr, Ai, Ai, Ai, Rra, Rra, Aa, Aa^Fma, Aa, Rra, Rra, Rra, Rra, Rra, Rra, Rra, Rra, Aa, Rra, Ai, Aa, Aa^Fpa, Ms, Ms, Rra, Rra, Ms, Ms
Wo, Wo, Wo, Wo, Wo, Wo, Ww, Ww, Ww, Ww, Ww, Wwr, Ai, Ai, Ai, Rra, Rra, Aa^Voa, Rra, Rra, Rra, Rra, Ai, Aa, Ai, Rra, Rra, Rra, Rra, Rra, Aa, Aa^Fpa, Rra, Rra, Aa^Fpa, Ms, Aa^Fpa, Aa^Fpa
Wo, Wo, Wo, Wo, Ww, Wo, Wo, Ww, Ww, Ww, Wwr, Wwr, Aa, Ai, Ai, Rra, Rra, Rra, Rra, Rra, Ai, Ai, Ai, Ai, Aa, Aa, Aa, Aa, Aa, Rra, Rra, Rra, Aa, Aa^Fpa, Aa, Aa^Fpa, Aa, Aa
Wo, Wo, Wo, Wo, Ww, Wo, Wo, Ww, Ww, Ww, Wwr, Wwr, Ai, Aa, Aa, Aa, Aa, Rra, Rra, Rra, Ai, Ai, Ai, Ai, Aa, Aa^Fpa, Aa^Fpa, Aa^Fpa, Aa^Fpa, Aa, Aa, Rra, Rra, Aa, Rra, Aa^Vla, Aa^Fpa, Aa^Fpa
Wo, Wo, Wo, Wo, Wo, Ww, Ww, Ww, Ww, Ww, Wwr, Wwr, Ai, Ai, Aa, Aa, Aa, Aa, Rra, Rra, Ai, Ai, Ai, Aa, Aa^Fpa, Aa^Fpa, Ms, Ms, Ms, Aa^Fpa, Aa, Rra, Rra, Rra, Rra, Aa^Fpa, Aa^Fpa, Aa^Fpa
Wo, Wo, Wo, Wo, Wo, Ww, Ww, Ww, Ww, Ww, Wwr, Ai, Ai, Aa, Rrc^Vhca, Rra, Rra, Aa, Rra, Rra, Ai, Ai, Aa, Aa, Aa^Fpa, Ms, Ms, Ms, Ms, Aa^Fpa, Aa^Fpa, Aa, Rra, Rra, Rra, Rra, Aa^Fpa, Aa^Fpa
Wo, Wo, Wo, Wo, Wo, Wo, Wo, Ww, Ww, Wwr, Wwr, Ai, Ai, Aa, Aa, Aa, Aa, Rra, Rra, Rra, Rra, Rra, Rra, Aa, Aa^Fpa, Ms, Ms, Ms, Ms, Ms, Aa^Fpa, Aa, Aa, Rra, Rra, Aa, Aa^Fpa, Aa^Fpa
Wo, Wo, Wo, Wo, Wo, Wo, Wo, Ww, Ww, Ww, Wwr, Ai, Ai, Aa, Wwr, Wwr, Ai, Ai, Rra, Rra, Ai, Ai, Aa, Rra, Rra, Ms, Rra, Ms, Ms, Ms, Ms, Aa^Fpa, Aa^Vha, Rra, Rra, Aa, Aa^Fpa, Aa^Fpa
Wo, Wo, Wo, Wo, Wo, Ww, Ww, Ww, Ww, Ww, Wwr, Wwr, Wwr, Wwr, Wwr, Wwr, Ai, Ai, Rra, Rra, Rra, Ai, Aa, Aa^Fpa, Ms, Rra, Rra, Aa^Vla, Ms, Ms, Ms, Aa^Fpa, Aa, Rra, Rra, Rra, Aa^Fpa, Aa^Fpa
Wo, Wo, Wo, Wo, Wo, Ww, Ww, Ww, Ww, Ww, Wwr, Wwr, Wwr, Wwr, Wwr, Aa, Ai, Ai, Rra, Rra, Ai, Ai, Aa, Aa^Fpa, Aa^Fpa, Ms, Ms, Ms, Ms, Ms, Ms, Aa^Fpa, Ai, Rra, Rra, Aa, Aa^Fpa, Aa^Fpa
Wo, Wo, Wo, Wo, Wo, Ww, Ww, Ww, Ww, Ww, Ai, Ai, Aa^Vea, Aa, Aa, Aa, Aa, Ai, Rra, Rra, Rra, Aa, Aa, Aa^Fpa, Aa^Fpa, Ms, Ms, Ms, Ms, Ms, Ms, Aa^Fpa, Ai, Rra, Rra, Rra, Aa^Fpa, Aa^Fpa
Wo, Wo, Wo, Wo, Wo, Ww, Ww, Ww, Ww, Wwr, Ai, Ai, Aa, Rra, Rra, Aa, Rra, Rra, Rra, Rra, Rra, Rra, Rra, Aa, Aa, Aa^Fpa, Aa^Fpa, Ms, Rra, Rra, Ms, Aa^Fpa, Aa, Ai, Rra, Aa, Aa^Fpa, Aa^Fpa
Wo, Wo, Wo, Wo, Wo, Wo, Ww, Ww, Ww, Wwr, Ai, Ai, Ai, Rra, Rra, Rra, Rra, Rra, Aa^Fma, Aa^Fma, Aa^Fma, Rra, Rra, Aa^Voa, Aa, Aa, Aa^Fpa, Ms, Aa^Fpa, Rra, Rra, Aa^Fpa, Aa, Rra, Rra, Rra, Aa^Fpa, Aa^Fpa
Wo, Wo, Wo, Wo, Wo, Wo, Wo, Ww, Ww, Wwr, Ai, Ai, Aa, Aa, Rra, Rra, Rra, Aa^Fma, Aa^Fma, Aa^Fma, Aa, Rra, Rra, Rra, Aa, Aa, Aa, Aa^Fpa, Aa^Fpa, Rra, Rra, Aa, Rra, Rra, Rra, Aa^Vla, Aa^Fpa, Aa^Fpa
Wo, Wo, Wo, Wo, Wo, Wo, Wo, Ww, Ww, Wwr, Ai, Ai, Ai, Rra, Rra, Rra, Aa, Aa^Fma, Aa, Aa, Aa^Fpa, Aa, Aa, Rra, Rra, Aa, Aa, Aa, Aa, Aa, Rra, Rra, Rra, Rra, Rra, Aa, Aa^Fpa, Aa^Fpa
Wo, Wo, Wo, Wo, Wo, Wo, Ww, Ww, Wwr, Ai, Ai, Ai, Rra, Rra, Aa, Aa, Aa^Fpa, Aa, Aa^Fpa, Aa^Fpa, Ms, Aa^Fpa, Aa, Rra, Rra, Rra, Rra, Rra, Rra, Rra, Rra, Rra, Rra, Rra, Rra, Aa, Aa, Aa^Fpa
Wo, Wo, Wo, Wo, Wo, Wo, Ww, Wwr, Ai, Ai, Ai, Ai, Rra, Rra, Aa, Aa^Fpa, Ms, Aa^Fpa, Ms, Ms, Aa^Fpa, Aa^Fpa, Aa, Aa, Ai, Rra, Rra, Rra, Rra, Rra, Rra, Rra, Ai, Ai, Aa, Rra, Rra, Aa
Wo, Wo, Wo, Wo, Ww, Wo, Ww, Wwr, Wwr, Ai, Ai, Aa^Fma, Rra, Aa, Aa^Fpa, Aa^Fpa, Ms, Ms, Ms, Ms, Aa^Fpa, Aa^Fpa, Aa, Aa, Ai, Ai, Rra, Rra, Rra, Rra, Ai, Ai, Ai, Ai, Aa, Aa, Aa^Fpa, Rra
Wo, Wo, Wo, Wo, Ww, Ww, Ww, Ww, Wwr, Ai, Ai, Aa, Rra, Aa, Aa^Fpa, Ms, Ms, Ms, Ms, Ms, Ms, Aa^Fpa, Aa, Aa, Aa, Ai, Rra, Rra, Cfa, Rra, Aa, Aa, Aa, Aa, Aa^Fpa, Aa^Fpa, Aa^Fpa, Aa^Fpa
Wo, Wo, Wo, Wo, Wo, Ww, Ww, Wwr, Wwr, Ai, Ai, Aa, Rra, Aa, Aa^Fpa, Ms, Ms, Ms, Ms, Ms, Ms, Aa^Fpa, Aa^Fpa, Aa, Aa, Aa, Cfa, Cfa, Cfa, Cfa, Cfa, Aa, Aa^Fpa, Aa^Fpa, Ms, Ms, Ms, Ms
Wo, Wo, Wo, Wo, Wo, Ww, Ww, Ww, Wwr, Wwr, Ai, Rra, Aa, Aa^Fpa, Ms, Ms, Ms, Ms, Ms, Ms, Ms, Ms, Aa^Fpa, Aa^Fpa, Aa, Aa, Cfa, Cfa, Kha, Cfa, Cfa, Aa, Aa^Fpa, Ms, Ms, Ms, Ms, Ms
Wo, Wo, Wo, Wo, Wo, Wo, Ww, Ww, Wwr, Wwr, Wwr, Aa^Vha, Aa, Aa^Fpa, Ms, Ms, Ms, Ms, Ms, Ms, Ms, Ms, Ms, Aa^Fpa, Aa^Fpa, Aa, Cfa, Cfa, Cfa, Kha, Cfa, Aa^Fpa, Ms, Ms, Ms, Ms, Ms, Ms
Wo, Wo, Wo, Wo, Wo, Wo, Wo, Ww, Ww, Wwr, Wwr, Aa, Aa, Aa^Fpa, Ms, Ms, Gs, Ms, Gs, Ms, Gs, Ms, Ms, Ms, Gs, Aa, Cfa, Cfa, Cfa, Cfa, Cfa, Aa^Fpa, Ms, Ms, Ms, Ms, Ms, Ms
