Gll, Gll, Qxua, Gll, Qxua, Gll, Gg, Gg, Gg, Gg, Gg, Gg, Gg, Gg, Gg, Gg, Gg, Gg, Gg, Gg, Gg, Gg, Gg, Gg, Gg, Gg, Gg, Gg, Hh, Gg, Hh, Gg, Hh, Hh, Hh, Hh, Hh, Hh, Hh, Hh, Hh, Hh, Hh, Hh, Hh, Gg
Gll, Gll, Gll, Qxua, Gll, Gll, Xoa, Gg, Xoa, Gg, Kh, Gg, Xoa, Qxua, Xoa, Gg, Xoa, Qxua, Xoi, Gg, Xoa, Gg, Kh, Gg, Xoa, Gg, Xoa, Gg, Kh, Gg, Gg, Hh, Hh, Hh, Hh, Hh, Hh, Hh, Hh, Hh, Hh, Hh, Hh, Hh, Hh, Hh
Gg, Hh, Hh, Hh, Rr, Kh, Rrc, Xoi, Rr^Vhc, Xoa, Kh, Xoa, Rr^Vhc, Xoa, Rr^Vhc, Xoi, Rr^Vhc, Xoa, Rr^Vhc, Xoi, Rr^Vhc, Xoa, Rrc, Xoa, Rr^Vhc, Xoa, Rp^Vhcr, Xoa, Isa, Kh, Xoa, Gg, Hh, Hh, Hh, Hh, Hh, Hh, Hh, Hh, Hh, Hh, Hh, Hh, Hh, Gg
Gg, Hh, Hh, Qxua, Urb, Xoa, Isa, Rrc, Rrc, Rrc, Rrc, Rrc, Rrc, Rp^Vhcr, Rp^Vhcr, Rp^Vhcr, Rp^Vhcr, Rr^Vhc, Rr^Vhc, Rr^Vhc, Rr^Vhc, Rp^Vhcr, Isa, Rp^Vhcr, Rp^Vhcr, Rr^Vhc, Rr^Vhc, Rr^Vhc, Isa, Isa, Isa, Xoi, Xoa, Hh, Kh, Hh, Kh, Hh, Hh, Hh, Hh, Hh, Hh, Hh, Urb, Hh
Urb, Hh, Urb, Urb, Urb, Rr^Pr/o, Isa, Isa, Isa, Rrc, Isa, Isa, Isa, Rrc, Isa, Rrc, Isa, Rp^Vhcr, Rp^Vhcr, Rrc, Isa, Isa, Isa, Rrc, Isa, Rp^Vhcr, Isa, Rrc, Rrc, Isa, Isa, Isa, Isa, Xoa, Rrc, Kh, Xoa, Xoa, Cf, Hh, Hh, Hh, Hh, Hh, Urb, Urb
Urb, Urb, Urb, Urb, Rr, Xoi, Isa, Isa, Rrc, Rrc, Rrc, Isa, Rrc, Isa, Rrc, Isa, Isa, Isa, Isa, Isa, Isa, Isa, Isa, Isa, Isa, Isa, Isa, Isa, Ch, Rrc, Ch, Rrc, Rrc, Rrc, Rrc, Rrc, Rrc, Rrc, Cf, Hh, Ww, Ww, Ww, Ww, Urb, Urb
Hh, Urb, Hh, Rr, Rr, Xoa, Isa, Ch, Ch, Ch, Ch, Ch, Rrc^Vhc, Rrc, Rr^Vhc, Isa^Vhc, Rr^Vhc, Rr^Vhc, Rr^Vhc, Rrc, Rrc^Vhc, Isa, Rrc, Isa, Rrc^Vhc, Isa, Ch, Ch, Ch, Ch, Ch, Ch, Ch, Rrc, Rrc, Rrc, Rrc, Rrc, Rrc, Xoa, Xoa, Ww, Ww, Ww, Urb, Urb
Qxua, Hh, Hh, Rr, Gg, Xoa, Isa, Ch, Kh, Kh, Kh, Ch, Rrc^Vhc, Rrc, Rp^Vhcr, Rr^Vhc, Rp^Vhcr, Rr^Vhc, Rr^Vhc, Rrc, Rrc^Vhc, Rrc^Vhc, Rrc, Rrc^Vhc, Rrc^Vhc, Rrc, Ch, Ch, Kh, Kh, Kh, Ch, Ch, Rrc, Rrc, Rrc, Rr^Vhc, Rrc, Rr^Vhc, Rrc, Rrc, Kh, Rrd^Dr, Ww, Urb, Urb
Hh, Qxua, Hh, Rr, Gg, Xoa, Rrc, Ch, Kh, Kh, Kh, Ch, Rr, Rrc, Rr^Vhc, Rp^Vhcr, Rp^Vhcr, Rp^Vhcr, Rr^Vhc, Rrc, Rr^Vhc, Rr^Vhc, Rrc, Rp^Vhcr, Rr, Rrc, Ch, Ch, Kh, Kh, Kh, Ch, Ch, Rrc, Rrc, Rr^Vhc, Rp^Vhcr, Rr^Vhc, Rrc, Rrc, Rrc, Xoa, Rrd^Dr, Ww, Urb, Urb
Hh, Qxua, Hh, Rr, Gg, Kh, Xoa, Isa, Ch, Ch, Ch, Ch, Rrc^Vhc, Rrc, Rr^Vhc, Rp^Vhcr, Rp^Vhcr, Rp^Vhcr, Isa, Rrc, Rrc^Vhc, Rrc^Vhc, Rrc, Rp^Vhcr, Rp^Vhcr, Rrc, Rrc, Ch, Ch, Ch, Ch, Ch, Rrc, Rrc, Rrc, Rp^Vhcr, Rr^Vhc, Rr^Vhc, Rr^Vhc, Rrc, Rrc, Xoi, Urb^Bsb/, Ww^Bsb/, Ww, Ww
Ww, Ww, Ww, Rrd, Rrd, Xoa, Xoa, Xoa, Ch, Ch, Ch, Ch, Rrc^Vhc, Rrc, Rrc^Vhc, Rrc^Vhc, Rrc, Rrc^Vhc, Rr^Vd, Rrc, Rrc^Vhc, Rrc^Vhc, Isa, Isa, Rrc, Rrc, Rrc, Rrc, Rrc, Rrc, Rrc, Rrc, Isa, Rrc, Rr^Vhc, Rp^Vhcr, Rp^Vhcr, Rr^Vhc, Rr^Vhc, Rrc, Rrc, Rr^Pr\o, Rrd^Dr, Ww, Ww, Ww
Ww, Ww, Ww, Ww, Xoa, Xoa, Isa, Rrc^Vh, Isa, Isa, Isa^Vhc, Isa, Rrc^Vhc, Rrc, Rrc^Vhc, Rrc^Vhc, Rrc, Rr^Vd, Rr^Vd, Rrc, Isa, Isa, Isa, Isa, Rrc, Rrc, Rrc, Rrc, Rrc, Rrc, Rrc, Isa, Isa, Rrc, Rrc, Rp^Vhcr, Rr^Vhc, Rr^Vhc, Rr^Vhc, Rr^Vhc, Rrc, Xoi, Rrd^Dr, Ww, Ww, Ww
Ww, Ww, Ww, Ww, Ch, Ch, Ch, Isa, Isa^Vhc, Isa, Isa, Isa, Isa, Rrc, Isa, Isa, Rrc, Isa, Isa, Rrc, Isa, Isa, Rrc, Kh, Cfr, Cfr, Cfr, Cfr, Cfr, Cfr, Kh, Rrc, Rrc, Rrc, Rrc, Rr^Vhc, Rr^Vhc, Rr^Vhc, Rr^Vhc, Rr^Vhc, Rrc, Xoa, Rrd^Dr, Ww, Ww, Ww
Ww, Ww, Ww, Ww, Ch, Kh, Ch, Isa, Isa, Isa, Isa, Isa, Rrc, Rrc, Isa, Rrc, Rrc, Isa, Rrc, Rrc, Isa, Rrc, Rrc, Cfr, Rrc, Rrc, Rrc, Rrc, Rrc, Rrc, Cfr, Cfr, Isa, Rrc, Rrc, Rrc, Rrc, Rr^Vhc, Rrc, Rrc, Rrc, Kh, Kh, Rrd^Dr, Ww, Ww
Gg, Hh, Hh, Hh, Ch, Ch, Ch, Isa, Isa^Vhc, Isa, Isa, Isa, Rrc, Rrc^Vhc, Rrc^Vhc, Rrc, Rr^Vd, Rrc^Vhc, Rrc, Rr^Vd, Rrc^Vhc, Rrc, Isa, Cfr, Rrc, Rrc, Rrc, Rrc, Rrc, Rrc, Cfr, Cfr, Isa, Rrc, Isa, Rrc, Rrc, Rrc, Isa, Rrc, Rrc, Kh, Kh, Rrd^Dr, Ww, Ww
Gg, Hh, Hh, Hh, Xoa, Rrc, Rrc, Rrc^Vhc, Rp^Vhcr, Rrc, Isa, Isa, Rrc, Rp^Vhcr, Rp^Vhcr, Rrc, Rr^Vd, Rrc^Vhc, Rrc, Rr^Vd, Rr^Vd, Isa^Eb, Isa, Kh, Cfr, Rrc, Cfr, Rrc, Cfr, Rrc, Kh, Isa, Isa, Isa, Isa, Rrc, Rr^Vd, Rr^Vd, Rr^Vd, Isa, Rrc, Kh, Rrd^Dr, Rrd^Dr, Ww, Ww
Ww, Ww, Hh, Hh, Xoa, Rrc, Isa, Rrc^Vhc, Rp^Vhcr, Rrc, Isa, Isa, Rrc, Rrc^Vhc, Rp^Vhcr, Rrc, Rrc^Vhc, Rr^Vd, Rrc, Rrc^Vhc, Rrc^Vhc, Rrc, Isa, Isa, Isa, Cfr, Isa, Cfr, Cfr, Cfr, Rp^Vhcr, Rrc^Vhc, Isa, Khr, Khr, Isa, Isa, Rr^Vd, Rr^Vd, Isa, Rrc, Xoa, Rrd^Dr, Rrd^Dr, Ww, Ww
Ww, Ww, Hh, Hh, Kh, Rrc, Rrc, Rrc^Vhc, Rrc^Vhc, Rp^Vhcr, Isa, Isa, Rrc, Rrc^Vhc, Rp^Vhcr, Rrc, Rrc^Vhc, Rr^Vd, Rrc, Rrc^Vhc, Rrc^Vhc, Rrc, Isa, Isa, Isa, Isa, Isa, Rrc, Isa, Isa, Isa, Isa, Isa, Isa, Isa, Isa, Isa, Isa, Isa, Isa, Rrc, Cf, Rrd^Dr, Rrd^Dr, Ww, Ww
Ww, Ww, Rrd^Dr, Hh, Xoa, Rrc, Rrc, Rrc^Vhc, Rrc^Vhc, Rrc, Isa, Isa, Rp, Rrc^Vhc, Rrc^Vhc, Rrc, Rrc^Vhc, Rrc^Vhc, Rrc, Rrc^Vhc, Rrc^Vhc, Rrc, Rrc^Vhc, Rrc^Vhc, Rrc, Isa, Isa, Isa, Rrc^Vhc, Isa, Isa, Isa, Isa, Isa, Isa, Isa, Isa, Isa, Isa, Isa, Rrc, Cf, Rrd^Dr, Ww, Ww, Ww
Ww, Ww, Rrd^Dr, Gg^Dr, Xoi, Rrc, Rrc, Isa, Isa, Isa, Isa, Isa, Isa, Isa, Isa, Rrc, Isa, Isa, Isa, Isa, Isa, Isa, Isa, Isa, Isa, Isa, Isa, Rrc, Isa, Isa, Isa, Rrc^Vhc, Isa, Isa, Khr, Khr, Khr, Isa, Isa, Rrc, Rrc, Xoa, Rrd^Dr, Ww, Ww, Ww
Ww, Ww, Wwr^Edb, Rrd^Dr, Xoi, Rrc, Rrc, Rrc, Rr, Rrc, Rrc, Rr, Rrc, Rrc, Rr, Isa, Rrc, Rr, Rrc, Rrc, Rr, Rrc, Rrc, Isa, Rrc, Isa, Rr, Isa, Rrc, Isa, Isa, Isa, Isa, Isa, Khr, Khr, Khr, Khr, Rrc, Rrc, Rrc, Xoa, Rrd^Dr, Ww, Ww, Ww
Ww, Ww, Wwr, Rrd^Dr, Xoa, Rrc, Rrc, Rr^Vhc, Rp^Vhcr, Rp^Vhcr, Rrc, Rp^Vhcr, Rp^Vhcr, Rrc^Vhc, Rrc, Rr^Vhc, Rr^Vhc, Isa, Isa, Isa, Rp^Vhcr, Isa, Rrc^Vhc, Rrc, Rrc^Vhc, Rp^Vhcr, Rp^Vhcr, Rrc^Vhc, Rrc^Vhc, Isa, Rrc, Isa, Isa, Rrc, Rrc, Khr, Rrc, Khr, Rrc, Rrc, Rrc, Xoa, Rrd^Dr, Ww, Ww, Ww
Ww, Ww, Wwr, Rrd^Dr, Kh, Rrc, Rrc, Rr^Vhc, Rr^Vhc, Rr^Vhc, Rrc, Rr^Vhc, Rp^Vhcr, Rr^Vhc, Rrc, Rr^Vhc, Rr^Vhc, Isa, Isa, Rp^Vhcr, Rp^Vhcr, Rp^Vhcr, Rp^Vhcr, Rrc, Rrc^Vhc, Rp^Vhcr, Rrc, Rp^Vhcr, Rp^Vhcr, Rrc, Rrc, Rrc, Rrc, Rrc, Rrc, Rrc, Rrc, Rrc, Rrc, Rrc, Kh, Kh, Rrd^Dr, Ww, Ww, Ww
Ww, Ww, Wwr, Rrd^Dr, Rrd^Dr, Xoa, Rrc, Rr^Vhc, Rr^Vhc, Rr^Vhc, Rrc, Rr^Vhc, Rr^Vhc, Rp^Vhcr, Rb, Rrc^Vhc, Rr^Vhc, Isa, Isa, Rr^Vhc, Rr^Vhc, Rr^Vhc, Rrc^Vhc, Rrc, Isa^Vhc, Rrc^Vhc, Rrc, Rrc^Vhc, Rrc^Vhc, Rrc, Rrc, Rrc, Xoa, Rrc, Xoa, Xoa, Xoa, Xoa, Xoa, Kh, Kh, Kh, Rrd^Dr, Ww, Ww, Ww
Ww, Ww, Wwr, Wwr, Rrd^Dr, Xoa, Isa, Isa, Isa, Rr^Vhc, Rrc, Rr^Vhc, Rr^Vhc, Rr^Vhc, Rrc, Rr^Vhc, Rrc, Isa, Rrc, Rr^Vhc, Rrc, Isa, Rrc, Rrc, Rrc, Rrc^Vhc, Rrc, Rrc^Vhc, Rrc, Rrc, Rrc, Rrc, Xoa, Xoa, Rrd^Dr, Rrd^Dr, Rrd^Dr, Rrd^Dr, Cme, Rrd^Dr, Rrd^Dr, Rrd^Dr, Ww, Ww, Ww, Ww
Ww, Ww, Wwr, Wwr, Rrd^Dr, Xoa, Xoa, Isa, Isa, Rrc, Rrc, Rrc, Rrc, Rrc, Rrc, Rrc, Isa, Rrc, Isa, Rrc, Rrc, Rrc, Xoi, Rrc, Rrc, Rrc, Rrc, Rrc, Rrc, Rrc, Xoa, Xoa, Cme, Rrd^Dr, Cme, Cme, Cme, Cme, Cme, Cme, Ww, Rrd^Dr, Ww, Ww, Ww, Ww
Ww, Ww, Ww, Wwr^Edb, Rrd^Edb, Rrd^Dr, Rrd^Dr, Kh, Kh, Xoa, Xoa, Xoa, Xoi, Xoa, Xoa, Xoa, Kh, Xoa, Kh, Xoa, Xoa, Xoa, Xoi, Xoa, Xoa, Xoa, Xoa, Xoa, Xoa, Xoa, Kh, Rrd^Dr, Wwr, Cme, Wwr, Cme, Cme, Cme, Cme, Cme, Cme, Ww, Ww, Ww, Wo, Wo
Wo, Ww, Ww, Wwr, Wwr, Rrd^Edb, Rrd^Edb, Rrd^Dr, Kh, Kh, Rrd^Dr, Rrd^Dr, Rrd^Dr, Rrd^Dr, Rrd^Dr, Rrd^Dr, Rrd^Dr, Rrd^Dr, Rrd^Dr, Rrd^Dr, Rrd^Dr, Rrd^Dr, Rrd^Dr, Rrd^Dr, Rrd^Dr, Rrd^Dr, Rrd^Dr, Kh, Kh, Kh, Rrd^Dr, Rrd^Edb, Wwr, Wwr, Wwr, Ww, Ww, Ww, Ww, Ww, Ww, Ww, Ww, Ww, Wo, Wo
Wo, Ww, Ww, Wwr, Wwr, Rrd^Edb, Wwr^Esd, Rrd^Edb, Wwr^Esd, Rrd^Dr, Xoa, Xoa, Rrd^Edb, Rrd^Edb, Wwr^Dr, Rrd^Edb, Wwr^Dr, Rrd^Edb, Wwr^Dr, Rrd^Edb, Wwr^Dr, Rrd^Edb, Rrd^Edb, Rrd^Edb, Wwr^Dr, Rrd^Edb, Rrd^Edb, Kh, Rrd^Dr, Rrd^Dr, Wwr, Rrd^Edb, Wwr, Wwr, Wwr, Ww, Ww, Ww, Ww, Ww, Ww, Ww, Wo, Wo, Wo, Wo
Ww^Vm, Wo, Wo, Ww, Ww, Wwr^Esd, Ww, Wwr^Esd, Ww, Wwr^Esd, Ww, Wwr^Esd, Ww, Wwr^Dr, Ww, Wwr^Dr, Ww, Wwr^Dr, Ww, Wwr^Esd, Wwr^Esd, Wwr^Esd, Wwr^Esd, Wwr^Esd, Wwr^Esd, Wwr^Dr, Wwr^Dr, Wwr^Esd, Wwr^Esd, Wwr^Esd, Ww, Wwr, Wwr, Wwr, Ww, Ww, Ww, Ww, Wo, Ww, Wo, Wo, Wo, Wo, Wo, Wo
Ww^Vm, Ww^Vm, Ww^Vm, Ww, Ww, Ww, Ww, Ww, Ww, Ww, Ww, Ww, Ww, Ww, Ww, Ww, Ww, Ww, Ww, Ww, Ww, Ww, Ww, Ww, Ww, Ww, Ww, Ww, Ww, Ww, Ww, Ww, Ww, Ww, Ww, Ww, Ww, Wo, Wo, Wo, Wo, Wo, Wo, Wo, Wo, Wo
Ww^Vm, Ww^Vm, Ww^Vm, Ww^Vm, Ww^Vm, Ww, Ww, Ww, Ww, Ww, Ww, Ww, Ww, Ww, Ww, Ww, Ww, Ww, Ww, Ww, Ww, Ww, Ww, Ww, Ww, Ww, Ww, Ww, Ww, Ww, Ww, Ww, Wo, Ww, Ww, Ww, Wo, Wo, Wo, Wo, Wo, Wo, Wo, Wo, Wo, Wo
Ww^Vm, Ww^Vm, Ww^Vm, Ww^Vm, Ww^Vm, Ww^Vm, Wo, Ww, Wo, Ww, Wo, Ww, Wo, Ww, Wo, Ww, Wo, Ww, Wo, Ww, Wo, Ww, Wo, Ww, Wo, Ww, Wo, Ww, Wo, Ww, Wo, Wo, Wo, Ww, Wo, Wo, Wo, Wo, Wo, Wo, Wo, Wo, Wo, Wo, Wo, Wo
Wo, Ww^Vm, Ww^Vm, Ww^Vm, Wo, Ww^Vm, Wo, Wo, Wo, Wo, Wo, Wo, Wo, Wo, Wo, Wo, Wo, Wo, Wo, Wo, Wo, Wo, Wo, Wo, Wo, Wo, Wo, Wo, Wo, Wo, Wo, Wo, Wo, Wo, Wo, Wo, Wo, Wo, Wo, Wo, Ww, Wo, Wo, Wo, Wo, Wo
