Gll, Gll, Qxua, Gll, Qxua, Gll, Gg, Gg, Gg, Gg, Gg, Gg, Gg, Gg, Gg, Gg, Gg, Gg, Gg, Gg, Gg, Gg, Gg, Gg, Gg, Gg, Gg, Gg, Hh, Gg, Hh, Gg, Hh, Hh, Hh, Hh, Hh, Hh, Hh, Hh, Hh, Hh, Hh, Hh, Hh, Gg
Gll, Gll, Gll, Qxua, Gll, Gll, Xoa, Gg, Xoa, Gg, Kh, Gg, Xoa, Qxua, Xoa, Gg, Xoa, Qxua, Xoi, Gg, Xoa, Gg, Kh, Gg, Xoa, Gg, Xoa, Gg, Kh, Gg, Gg, Hh, Hh, Hh, Hh, Hh, Hh, Hh, Hh, Hh, Hh, Hh, Hh, Hh, Hh, Hh
Gg, Hh, Rrc, Hh, Rrc, Kh, Rrc, Xoi, Rrc, Xoa, Kh, Xoa, Isa, Xoa, Isa, Xoi, Isa, Xoa, Isa, Xoi, Rrc, Xoa, Rrc, Xoa, Isa, Xoa, Rrc, Xoa, Isa, Kh, Xoa, Gg, Hh, Hh, Hh, Hh, Hh, Hh, Hh, Hh, Hh, Hh, Hh, Hh, Hh, Gg
Gg, Rrc, Hh, Qxua, Urb, Xoa, Isa, Rrc, Rrc^Eqp, Rrc, Rrc, Isa, Rrc, Isa, Rrc, Isa, Rrc, Isa, Isa, Rrc, Rrc^Eqf, Rrc, Isa, Isa, Isa, Rrc, Rrc, Rrc, Isa^Eqf, Isa, Isa, Xoi, Xoa, Hh, Kh, Hh, Kh, Hh, Hh, Hh, Hh, Hh, Hh, Hh, Urb, Hh
Urb, Hh, Urb, Urb, Urb, Rr^Pr/o, Isr, Isa, Isa, Isa^Eqp, Isa, Isa, Isa, Rrc, Isa, Rr^Vhc, Isa, Rrc, Rrc, Rrc^Eqf, Isa, Isa, Isa, Rr^Vhc, Isa, Rrc, Rrc, Rrc^Eqf, Rrc, Isa^Eqf, Isa, Isa, Isa, Xoa, Rrc, Kh, Xoa, Xoa, Cf, Hh, Hh, Hh, Hh, Hh, Urb, Urb
Urb, Urb, Urb, Urb, Rr, Xoi, Isa, Isa, Rrc, Isa, Rrc, Isa, Rrc^Ebn, Isa, Isa, Isa, Isa, Isa, Isa, Rr^Pr\o, Isa, Isa, Isa^Eqf, Isa, Isa, Isa, Isa, Isa, Ch, Rrc^Ebn, Ch, Rr^Vhc, Rrc, Rrc, Rrc, Rrc, Rrc, Rrc, Cf, Hh, Ww, Ww, Ww, Ww, Urb, Urb
Hh, Urb, Hh, Rr, Rr, Xoa, Isa, Ch, Ch, Ch, Ch, Ch, Rrc, Rrc, Isa, Rrc, Rrc, Rrc, Rr^Vhc, Rrc, Isa, Isa^Eqf, Rrc^Eqf, Isa^Eqf, Rr^Vhc, Isa, Ch, Ch, Ch, Ch, Ch, Ch, Ch, Rrc, Rr^Vhc, Rrc, Isa, Rrc, Isa, Xoa, Xoa, Ww, Ww, Ww, Urb, Urb
Qxua, Hh, Hh, Rr, Gg, Xoa, Isa, Ch, Kh, Kh, Kh, Ch, Rrc, Rr^Vhc, Isa, Rrc, Rr^Vhc, Rrc, Rrc, Rrc, Rrc, Rrc, Rrc, Rrc, Rrc, Rrc^Ebn, Ch, Ch, Kh, Kh, Kh, Ch, Ch, Rrc, Rrc, Rrc, Rrc, Isa, Isa, Isa, Isa, Kh, Rrd^Dr, Ww, Urb, Urb
Hh, Qxua, Hh, Rr, Gg, Xoa, Rrc, Ch, Kh, Kh, Kh, Ch, Rr, Rrc, Isa, Rrc, Rrc, Rrc, Isa, Isa, Rrc^Eqf, Rr^Vhc, Isa, Rrc, Rrc, Rrc, Ch, Ch, Kh, Kh, Kh, Ch, Ch, Rrc^Ebn, Rrc^Eqf, Rrc^Eqf, Rrc, Rrc, Rrc, Isa, Isa, Xoa, Rrd^Dr, Ww, Urb, Urb
Hh, Qxua, Hh, Rr, Gg, Kh, Xoa, Isa, Ch, Ch, Ch, Ch, Rrc, Rrc, Isa, Rrc, Rr^Vhc, Rrc, Isa, Rrc^Eqf, Rrc, Rrc, Rrc, Isa, Rrc, Rrc, Rrc, Ch, Ch, Ch, Ch, Ch, Rrc, Rrc, Rrc, Rr^Vhc, Rrc, Rrc, Rrc, Rrc, Rrc, Xoi, Urb^Bsb/, Ww^Bsb/, Ww, Ww
Ww, Ww, Ww, Rrd, Rrd, Xoa, Xoa, Xoa, Ch, Ch, Ch, Ch, Rrc, Rrc, Isa, Rrc, Isa, Isa, Rrc, Rr^Pr\, Rrc, Rr^Vhc, Isa, Isa, Isa, Rrc^Eqf, Rrc^Eqf, Rrc, Rrc, Rrc^Ebn, Rrc, Rrc, Isa, Rr^Vhc, Rrc, Rrc, Rrc, Rrc, Rrc, Rrc, Isr, Rr^Pr\o, Rrd^Dr, Ww, Ww, Ww
Ww, Ww, Ww, Ww, Xoa, Xoa, Isa, Rrc^Vh, Isa, Isa, Isa, Isa, Isa, Rrc, Isa, Isa, Isa, Rrc, Isa, Rrc, Isa, Isa, Isa, Isa, Isa, Rrc^Ebn, Rrc, Rrc^Eqf, Rrc^Eqf, Rrc, Rrc, Isa, Isa, Rrc^Eqf, Rrc^Eqf, Rrc, Rrc, Rrc, Isa, Rrc, Rrc, Xoi, Rrd^Dr, Ww, Ww, Ww
Ww, Ww, Ww, Ww, Ch, Ch, Ch, Isa, Rrc, Isa, Isa, Isa, Isa, Isa, Isa, Isa, Rrc^Eqf, Isa^Eqf, Isa, Isa, Isa, Isa, Rrc, Kh, Cfr, Isa, Cfr, Cfr, Cfr, Cfr, Kh, Rrc, Rrc, Rrc^Eqf, Isa, Isa, Isa, Isa, Isa, Isa, Isa, Xoa, Rrd^Dr, Ww, Ww, Ww
Ww, Ww, Ww, Ww, Ch, Kh, Ch, Isa, Isa, Isa, Isa, Isa, Rrc, Rr^Vhc, Isa^Eqf, Rrc^Eqf, Rrc, Isa, Rrc, Rr^Vhc, Isa, Rrc, Rrc, Cfr, Isr, Isr, Isr, Isr, Isr, Isr, Cfr, Cfr, Isa, Isa, Isa, Isa, Isa, Isa, Isa, Isa, Rrc, Kh, Kh, Rrd^Dr, Ww, Ww
Gg, Hh, Hh, Hh, Ch, Ch, Ch, Isa, Rrc, Isa, Isa, Isa, Rrc, Rrc, Rrc^Eqf, Rrc^Eqf, Rrc^Ebn, Rrc, Rrc, Rrc, Rrc, Rrc, Isa, Cfr, Isr, Isr, Isr, Isr, Isr, Isr, Cfr, Cfr, Isa, Rr^Vhc, Isa, Rrc, Rrc, Rrc, Isa, Rrc, Rrc, Kh, Kh, Rrd^Dr, Ww, Ww
Gg, Hh, Hh, Hh, Xoa, Rrc, Rrc^Ebn, Rrc^Eqp, Rrc^Eqp, Rrc, Isa, Isa, Rrc, Rrc, Rr^Pr\o, Rrc, Rr^Vhc, Rrc, Rrc, Rrc, Rr^Vhc, Isa^Eb, Isa, Kh, Cfr, Isr, Cfr, Isr, Cfr, Isr, Kh, Isa, Isa, Isa, Isa, Rrc, Rr^Vhc, Rrc, Rrc, Isa, Rrc^Eqp, Kh, Rrd^Dr, Rrd^Dr, Ww, Ww
Ww, Ww, Hh, Hh, Xoa, Rrc, Isa, Rrc, Rr^Vhc, Rrc, Isa, Isa, Isa, Isa, Isa, Isa, Isa, Isa, Isa, Isa, Isa, Isa, Isa, Isa, Isa, Cfr, Isa, Cfr, Cfr, Cfr, Rrc, Rrc, Isa, Khr, Khr, Isa, Isa, Rrc, Rr^Vhc, Isa, Rrc^Eqp, Xoa, Rrd^Dr, Rrd^Dr, Ww, Ww
Ww, Ww, Hh, Hh, Kh, Rrc, Rrc, Rr^Vhc, Rr^Vhc, Rrc, Isa, Isa, Rrc, Isa, Rrc^Eqf, Isa, Rrc^Eqf, Rrc^Eqf, Rrc^Eqf, Isa, Rrc^Eqf, Isa, Isa, Isa, Isa, Isa, Isa, Rrc, Isa, Isa, Isa, Isa, Isa, Isa, Isa, Isa, Isa, Isa, Isa, Isa, Rrc^Eqp, Cf, Rrd^Dr, Rrd^Dr, Ww, Ww
Ww, Ww, Rrd^Dr, Hh, Xoa, Rrc, Rrc, Rrc, Rrc^Eqp, Rrc^Eqp, Isa, Isa, Rp, Rrc, Isa, Rrc^Eqf, Rrc, Rrc, Rrc, Rrc^Eqf, Rr^Vhc, Rrc^Eqf, Rr^Vhc, Rrc, Rrc, Isa, Isa, Isa, Rrc, Rr^Pr\, Isa^Eqf, Isa, Isa, Isa, Isa, Isa, Isa, Isa, Isa, Isa, Rrc^Eqp, Cf, Rrd^Dr, Ww, Ww, Ww
Ww, Ww, Rrd^Dr, Gg^Dr, Xoi, Isa, Isa, Isa, Isa, Isa, Isa, Isa, Isa, Isa, Isa, Isa, Isa, Isa, Isa, Isa, Isa, Isa, Isa, Isa, Isa, Isa, Isa, Rrc, Isa, Isa, Isa, Rrc^Eqf, Isa, Isa, Khr, Khr, Khr, Isa, Isa^Eqp, Rrc^Eqp, Rrc, Xoa, Rrd^Dr, Ww, Ww, Ww
Ww, Ww, Wwr^Edb, Rrd^Dr, Xoi, Rrc, Rrc^Eqp, Isa, Isa, Isa, Rrc, Isa, Isa, Isa, Isa, Isa, Isa, Isa, Isa, Isa, Rr, Isa, Rrc, Isa, Rrc, Isa, Rr^Eqf, Isa, Isa, Isa, Isa, Rr^Pr/o, Isa, Isa, Khr, Khr, Khr, Khr, Rrc, Rrc, Rrc, Xoa, Rrd^Dr, Ww, Ww, Ww
Ww, Ww, Wwr, Rrd^Dr, Xoa, Rrc, Rrc, Rrc^Eqp, Rrc^Eqp, Isa, Isa, Rrc, Rrc, Rrc, Rr^Vhc, Rrc, Rr^Vhc, Isa, Isa, Isa, Rrc, Rrc, Rrc, Rrc, Rrc, Rrc, Rrc^Eqf, Rrc^Eqf, Isa, Isa, Isa, Isa, Isa, Rrc, Rrc, Khr, Rrc, Khr, Rrc, Rr^Vhc, Rrc, Xoa, Rrd^Dr, Ww, Ww, Ww
Ww, Ww, Wwr, Rrd^Dr, Kh, Rrc, Rrc, Rrc, Rrc, Isa, Isa, Rrc, Rrc, Rrc, Rrc, Rrc, Rrc, Isa, Isa, Rrc, Rrc, Rrc, Rrc, Rrc, Rrc^Eqf, Rrc^Eqf, Rrc, Rrc, Rr^Vhc, Isa, Isa, Isa, Isa, Rrc, Rrc, Rrc, Rrc, Rrc, Rrc, Rrc, Kh, Kh, Rrd^Dr, Ww, Ww, Ww
Ww, Ww, Wwr, Rrd^Dr, Rrd^Dr, Xoa, Rrc, Rr^Vhc, Rr^Vhc, Rrc, Isa, Isa, Rrc, Rrc, Rb, Rrc, Rr^Vhc, Isa, Isa, Rrc, Rrc, Rr^Vhc, Rr^Vhc, Rrc, Rrc, Rrc, Rrc, Rrc, Rrc, Rr^Vhc, Isa, Isa, Isa, Isa, Xoa, Xoa, Xoa, Xoa, Xoa, Kh, Kh, Kh, Rrd^Dr, Ww, Ww, Ww
Ww, Ww, Wwr, Wwr, Rrd^Dr, Xoa, Isa, Isa, Isa, Rr^Vhc, Rrc, Isa, Isa, Rrc, Rrc, Rrc, Rrc, Isa, Isa, Rrc, Rrc, Isa, Rrc, Rrc, Rrc, Rrc, Rrc, Rrc, Rrc, Rrc, Isa, Isa, Xoa, Xoa, Rrd^Dr, Rrd^Dr, Rrd^Dr, Rrd^Dr, Cme, Rrd^Dr, Rrd^Dr, Rrd^Dr, Ww, Ww, Ww, Ww
Ww, Ww, Wwr, Wwr, Rrd^Dr, Xoa, Xoa, Isa, Isa, Rrc, Isa, Isa, Isa, Isa, Isa, Isa, Isa, Isa, Isa, Isa, Isa, Rrc, Xoi, Isa, Isa, Isa, Isa, Rrc, Isa, Isa, Xoa, Xoa, Cme, Rrd^Dr, Cme, Cme, Cme, Cme, Cme, Cme, Ww, Rrd^Dr, Ww, Ww, Ww, Ww
Ww, Ww, Ww, Wwr^Edb, Rrd^Edb, Rrd^Dr, Rrd^Dr, Kh, Kh, Xoa, Xoa, Xoa, Xoi, Xoa, Xoa, Xoa, Kh, Xoa, Kh, Xoa, Xoa, Xoa, Xoi, Xoa, Xoa, Xoa, Xoa, Xoa, Xoa, Xoa, Kh, Rrd^Dr, Wwr, Cme, Wwr, Cme, Cme, Cme, Cme, Cme, Cme, Ww, Ww, Ww, Wo, Wo
Wo, Ww, Ww, Wwr, Wwr, Rrd^Edb, Rrd^Edb, Rrd^Dr, Kh, Kh, Rrd^Dr, Rrd^Dr, Rrd^Dr, Rrd^Dr, Rrd^Dr, Rrd^Dr, Rrd^Dr, Rrd^Dr, Rrd^Dr, Rrd^Dr, Rrd^Dr, Rrd^Dr, Rrd^Dr, Rrd^Dr, Rrd^Dr, Rrd^Dr, Rrd^Dr, Kh, Kh, Kh, Rrd^Dr, Rrd^Edb, Wwr, Wwr, Wwr, Ww, Ww, Ww, Ww, Ww, Ww, Ww, Ww, Ww, Wo, Wo
Wo, Ww, Ww, Wwr, Wwr, Rrd^Edb, Wwr^Esd, Rrd^Edb, Wwr^Esd, Rrd^Dr, Xoa, Xoa, Rrd^Edb, Rrd^Edb, Wwr^Dr, Rrd^Edb, Wwr^Dr, Rrd^Edb, Wwr^Dr, Rrd^Edb, Wwr^Dr, Rrd^Edb, Rrd^Edb, Rrd^Edb, Wwr^Dr, Rrd^Edb, Rrd^Edb, Kh, Rrd^Dr, Rrd^Dr, Wwr, Rrd^Edb, Wwr, Wwr, Wwr, Ww, Ww, Ww, Ww, Ww, Ww, Ww, Wo, Wo, Wo, Wo
Ww^Vm, Wo, Wo, Ww, Ww, Wwr^Esd, Ww, Wwr^Esd, Ww, Wwr^Esd, Ww, Wwr^Esd, Ww, Wwr^Dr, Ww, Wwr^Dr, Ww, Wwr^Dr, Ww, Wwr^Esd, Wwr^Esd, Wwr^Esd, Wwr^Esd, Wwr^Esd, Wwr^Esd, Wwr^Dr, Wwr^Dr, Wwr^Esd, Wwr^Esd, Wwr^Esd, Ww, Wwr, Wwr, Wwr, Ww, Ww, Ww, Ww, Wo, Ww, Wo, Wo, Wo, Wo, Wo, Wo
Ww^Vm, Ww^Vm, Ww^Vm, Ww, Ww, Ww, Ww, Ww, Ww, Ww, Ww, Ww, Ww, Ww, Ww, Ww, Ww, Ww, Ww, Ww, Ww, Ww, Ww, Ww, Ww, Ww, Ww, Ww, Ww, Ww, Ww, Ww, Ww, Ww, Ww, Ww, Ww, Wo, Wo, Wo, Wo, Wo, Wo, Wo, Wo, Wo
Ww^Vm, Ww^Vm, Ww^Vm, Ww^Vm, Ww^Vm, Ww, Ww, Ww, Ww, Ww, Ww, Ww, Ww, Ww, Ww, Ww, Ww, Ww, Ww, Ww, Ww, Ww, Ww, Ww, Ww, Ww, Ww, Ww, Ww, Ww, Ww, Ww, Wo, Ww, Ww, Ww, Wo, Wo, Wo, Wo, Wo, Wo, Wo, Wo, Wo, Wo
Ww^Vm, Ww^Vm, Ww^Vm, Ww^Vm, Ww^Vm, Ww^Vm, Wo, Ww, Wo, Ww, Wo, Ww, Wo, Ww, Wo, Ww, Wo, Ww, Wo, Ww, Wo, Ww, Wo, Ww, Wo, Ww, Wo, Ww, Wo, Ww, Wo, Wo, Wo, Ww, Wo, Wo, Wo, Wo, Wo, Wo, Wo, Wo, Wo, Wo, Wo, Wo
Wo, Ww^Vm, Ww^Vm, Ww^Vm, Wo, Ww^Vm, Wo, Wo, Wo, Wo, Wo, Wo, Wo, Wo, Wo, Wo, Wo, Wo, Wo, Wo, Wo, Wo, Wo, Wo, Wo, Wo, Wo, Wo, Wo, Wo, Wo, Wo, Wo, Wo, Wo, Wo, Wo, Wo, Wo, Wo, Ww, Wo, Wo, Wo, Wo, Wo
