Mm, Mm, Mm, Mm, Qxua, Qxua, Mm, Mm, Mm, Mm, Mm, Mm, Mm, Mm, Mm, Mm, Gll^Fp, Ss, Ww, Gll^Fp, Gll^Fp, Gll^Fp, Gll^Fp, Gll^Fp, Gll^Fp, Gll^Fdf, Gll^Fp, Gll^Fp, Mm, Mm, Mm, Mm, Mm, Mm, Mm, Mm, Mm, Mm, Mm, Mm, Mm, Mm, Gg, Gg, Gg, Gg
Mm, Mm, Mm, Qxua, Qxua, Mm, Mm, Mm, Mm, Mm, Gll^Fmf, Gll^Fp, Gll^Fp, Gll^Fp, Re, Re, Re, Re, Ww, Re, Gll^Fp, Gll^Fp, Gll^Fp, Gll^Fp, Gll^Fp, Gll^Fp, Gll^Fp, Gll^Fp, Mm, Mm, Mm, Mm, Mm, Mm, Mm, Mm, Mm, Mm, Mm, Mm, Mm, Mm, Gg, Gg, Gg, Gg
Mm, Mm, Qxua, Mm, Mm, Hh, Hh, Gll^Fp, Gll^Fp, Gll^Fp, Gll^Fp, Gll^Fp, Gll^Fp, Gll^Fmf, Re, Re, Re, Re, Re, Ww, Re, Gll^Fp, Gll^Fp, Gll^Fp, Gll^Fp, Gll^Fdf, Gll^Fdf, Gll^Fp, Hh, Hh, Hh, Gll^Fdf, Gll^Feth, Gll^Fetd, Gll^Fetd, Gll^Fdf, Gll^Feth, Gll^Feth, Gll^Feth, Mm, Hh, Hh, Gg, Gg, Gg, Gg
Mm, Mm, Mm, Mm, Mm, Gll^Fp, Gll^Fmf, Gll^Fp, Gll^Fdf, Gll^Fp, Gll^Fp, Gll^Fp, Gll^Fp, Gll^Fetd, Re, Re, Re, Re, Re, Re, Ww, Re, Gll^Fp, Gll, Gll^Fp, Gll^Fp, Gll^Fmf, Gll^Fp, Gll^Fp, Gll^Feth, Gll^Fdf, Gll^Fp, Gll^Fetd, Xoa, Xoa, Urb^Es, Xoa, Xoa, Gll^Feth, Gll^Fetd, Hh, Hh, Gg, Gg, Gg, Gg
Mm, Mm, Mm, Hh, Hh, Gll^Fp, Gll^Fp, Gll^Fp, Gll^Fp, Gll^Fp, Gll^Fp, Gll^Fp, Gll^Fp, Gll^Fp, Gll^Fp, Gll^Fp, Gll^Fp, Gll^Fp, Re, Re, Ww, Re, Re, Gll^Fp, Gll^Fp, Gll^Fp, Gll^Fp, Gll^Fp, Gll^Fp, Gll^Fetd, Gll^Fdf, Gll^Feth, Xoa, Urb, Urb^Eb, Urb, Urb^Eb, Xoa, Gll^Feth, Gll^Fp, Hh, Hh, Gg, Gg, Gg, Gg
Mm, Mm, Mm, Hh, Hh, Gll^Fp, Gll^Fp, Gll^Fmf, Gll^Fp, Gll^Fp, Gll^Fp, Isa^Es, Isa^Es, Isa^Es, Gll^Fp, Gll^Fmf, Gll^Fp, Gll^Fp, Gll^Fmf, Re, Re, Ww^Bw/, Re, Re, Gll^Fdf, Gll^Fp, Gll^Fp, Gll^Fmf, Gll^Fp, Gll^Fetd, Gll^Feth, Gll^Fetd, Xoa, Urb^Eb, Urb, Urb, Urb, Urb^Eb, Gll^Fdf, Gll^Fetd, Hh, Hh, Gg, Gll^Fp, Gll^Fp, Gg
Mm, Mm, Mm, Hh, Hh, Gll^Fp, Gll^Fp, Gll^Fp, Gll^Fp, Gll^Fp, Isa^Es, Isa^Es, Isa^Es, Isa^Es, Isa^Es, Gll, Gll^Fp, Gll^Fp, Gll^Fp, Gll^Fp, Re, Re, Ww, Re, Re, Gll^Fp, Gll^Fp, Gll^Fp, Gll^Fp, Gll^Fetd, Gll^Fetd, Gll^Fetd, Urb^Es, Urb^Eb, Urb, Khr, Urb, Urb^Eb, Urb^Es, Gll^Fetd, Hh, Hh, Gg, Gll^Fp, Gll^Fp, Gg
Mm, Mm, Mm, Hh, Hh, Gll^Fp, Gll^Fp, Gll^Fp, Gll^Fp, Isa^Es, Isa^Es, Isa, Isa, Isa, Isa^Es, Isa^Es, Gll^Fmf, Gll^Fp, Gll^Fp, Gll^Fp, Gll^Fp, Re, Ww, Re, Re, Re, Gll^Fp, Gll^Fp, Gll^Fp, Gll^Fetd, Gll^Fetd, Xoa, Xoa, Urb, Urb^Eb, Urb, Urb^Eb, Gll^Fdf, Gll^Fetd, Gll^Fetd, Gll^Fetd, Gll^Fp, Gg, Gll^Fp, Gll^Fp, Gg
Mm, Mm, Mm, Hh, Hh, Gll^Fp, Gll^Fp, Gll^Fdf, Gll^Fp, Isa^Es, Isa^Es, Isa, Isa^Ebn, Isa, Isa^Es, Isa^Es, Gll^Fp, Gll^Fetd, Gll^Fp, Rrc, Ss, Ww, Re, Re, Re, Re, Gll^Fp, Gll^Fp, Gll^Fp, Gll^Feth, Gll^Fetd, Rrc^Pr|o, Re, Re, Re, Re, Gll^Fdf, Xoa, Gll^Fdf, Gll^Fetd, Gll^Fp, Gll, Gg, Gll^Fp, Gg, Gg
Mm, Mm, Mm, Hh, Hh, Gll^Fp, Gll^Fp, Gll^Fp, Gll^Fp, Isa^Es, Isa^Es, Isa, Isa, Isa, Isa^Es, Isa^Es, Gll^Fp, Gll^Fp, Rrc, Isa^Es, Ww, Rrc^Vhr, Gll^Fp, Re, Re, Re, Gll^Fp, Gll^Fp, Gll^Fmf, Gll^Fetd, Gll^Fp, Re, Gll^Fdf, Gll^Fdf, Gll^Fp, Gll^Fetd, Gll^Fetd, Gll^Fdf, Gll^Fp, Gll^Fetd, Gll^Feth, Gll^Fp, Gg, Gll^Fp, Gd^Fetd, Gg
Mm, Mm, Mm, Hh, Hh, Rrc^Vhr, Gll^Fp, Gll^Fp, Gll^Fp, Gll^Fmf, Isa^Es, Isa^Es, Isa^Es, Isa^Es, Isa^Es, Gll^Fdf, Gll^Fp, Gll^Fp, Ss, Ww, Ss, Gll^Fp, Re, Re, Re, Re, Gll^Fdf, Gll^Fp, Gll^Fp, Gll^Fetd, Re, Gll^Fp, Gll^Fetd, Gll^Fetd, Gll^Fetd, Gll^Fetd, Gll^Fetd, Gll^Fetd, Gll^Fetd, Gll^Fetd, Gll^Fdf, Gll^Fp, Gg, Gll^Fp, Gd^Fetd, Gg
Mm, Mm, Mm, Hh, Gll^Fmf, Gll^Fp, Gll^Fp, Rb, Rb, Rb, Gll, Isa^Es, Isa^Es, Isa^Es, Gll^Fp, Rrc^Edt, Gll^Fp, Gll, Rrc^Pr|o, Ss, Gll^Fp, Re, Re, Re, Re, Re, Rrc^Vh, Gll^Fp, Gll^Fmf, Gll^Fp, Gll^Fp, Gll^Fmf, Rrc^Vhr, Gll^Fp, Gll^Fp, Gll^Fmf, Gll^Fmf, Gll^Fp, Gll^Fmf, Gll^Fp, Gll^Fmf, Gll^Fp, Gg, Gll^Fp, Gd^Fetd, Gg
Gll^Fp, Gll^Fmf, Gll^Fp, Gll^Fetd, Gll^Fetd, Gll^Fp, Gll^Fp, Rrc^Vhr, Rb, Rb, Gll^Fmf, Gll^Fp, Gll, Gll^Fetd, Gll^Fdf, Gll^Fp, Gll^Fp, Ss, Ww, Ss, Re, Re, Re, Re, Ww^Bw|, Gll^Fetd, Gll^Fp, Gll^Fdf, Gll, Gll, Gll^Fp, Gll^Fp, Gll, Gll, Gll^Fp, Gll^Fp, Gll^Fp, Gll^Fp, Gll^Fmf, Gll^Fdf, Gll^Fmf, Gll^Fmf, Gg, Gll^Fp, Gd^Fetd, Gg
Gll^Fmf, Gll^Fp, Gll^Fp, Gll^Fp, Gll^Fdf, Gll^Fp, Gll^Fp, Rb, Rb, Rb, Gll^Fp, Gll^Fmf, Gll^Fp, Gll^Fp, Gll^Fp, Gll, Gll^Fetd, Gll, Ss, Ww, Re, Re, Re, Re, Xor, Xor, Xor, Gll^Fp, Gll^Fp, Gll^Fp, Gll^Fp, Gll^Fp, Gll^Fdf, Gll^Fp, Gll^Fp, Gll^Fp, Gll^Fetd, Gll^Fmf, Gll^Fp, Gll^Fp, Gll^Fmf, Gll^Fp, Gg, Gll^Fp, Gll^Fp, Gg
Gll^Fp, Gll^Fp, Gll^Fp, Gll, Gll^Fp, Gll^Fp, Gll^Fp, Rb, Rb, Rb, Gll^Fp, Gll^Fp, Gll^Fdf, Gll, Rrc^Vhr, Gll, Gll, Gll, Re, Re, Ww, Re, Re, Gll, Gll^Fp, Gll^Fmf, Gll^Fp, Gll^Fp, Gll, Gll^Fp, Ch, Kh, Gll, Gll^Fp, Gll, Gll^Fp, Gll^Fp, Gll^Fp, Gll^Fp, Gll^Fp, Gll^Fp, Gll^Fp, Gg, Gll^Fp, Gg, Gg
Gll^Fp, Gll^Fp, Gll^Fp, Gll^Fp, Gll^Fp, Gll, Gll^Fp, Rb, Rb, Rb, Gll^Fp, Gll^Fp, Gll^Fp, Gll^Fp, Gll^Fp, Gll^Fp, Gll^Fp, Re, Re, Re, Re, Ww, Ss, Gll^Fmf, Gll^Fp, Gll^Fp, Gll^Fmf, Gll^Fp, Gll^Fmf, Gll^Fp, Isa^Es, Isa^Es, Isa^Es, Gll^Fmf, Rrc^Vhr, Gll^Fp, Gll, Gll^Fp, Gll^Fp, Gll^Fp, Gll^Fp, Gll^Fp, Gg, Gll^Fp, Gg, Gg
Gll^Fp, Gll^Fdf, Gll^Fp, Gll^Fp, Gll, Gll^Fp, Gll^Fp, Rb, Rb, Rb, Rb, Gll^Fdf, Rrc, Gll^Fp, Gll, Gll^Fp, Ww^Bw\, Rb, Rb, Re, Re, Ww, Gll^Fmf, Gll^Fp, Gll, Gll^Fmf, Gll^Fetd, Gll^Fmf, Gll^Fp, Isa^Es, Isa^Es, Isa^Es, Isa^Es, Isa^Es, Gll^Fp, Gll^Fp, Gll^Fp, Gll^Fp, Gll^Fp, Gll^Fp, Gll^Fp, Gll^Fp, Gd^Fetd, Gll^Fp, Gg, Gg
Gll^Fp, Gll^Fp, Gll^Fp, Gll^Fp, Gll^Fp, Gll^Fp, Gll^Fp, Rb, Rb, Rb, Rb, Rrc, Isa^Es, Ch, Kh, Re, Rb, Rb, Rb, Re, Ww, Ss, Gll, Gll^Fp, Gll^Fp, Gll^Fmf, Gll^Fmf, Re^Edt, Isa^Es, Isa^Es, Isa, Isa, Isa, Isa^Es, Isa^Es, Gll^Fp, Gll^Fp, Gll^Fp, Gll^Fp, Gll^Fmf, Gll^Fp, Gll^Fmf, Gd^Fetd, Gll^Fp, Gll^Fp, Gg
Gll^Fp, Gll^Fp, Gll^Fmf, Gll^Fp, Gll^Fp, Gll^Fp, Gll^Fdf, Gll^Fmf, Rrc^Vhr, Rb, Xor, Xor, Xor, Gll^Fmf, Re, Re, Rb, Rb, Rb, Ww, Ss, Gll, Gll^Fp, Gll^Fp, Gll, Gll^Fp, Gll^Fp, Gll^Fp, Isa^Es, Isa^Es, Isa, Isa^Ebn, Isa, Isa^Es, Isa^Es, Gll^Fdf, Rrc^Vhr, Gll^Fmf, Gll^Fp, Gll^Fp, Gll^Fp, Gll^Fp, Gd^Fetd, Gd^Fetd, Gll^Fp, Gg
Gll^Fp, Gll^Fp, Gll^Fp, Gll^Fp, Gll^Fdf, Gll^Fp, Gll^Fdf, Gll^Fp, Gll^Fp, Rb, Rb, Rb, Rb, Rb, Re, Isa^Es, Isa^Es, Isa^Es, Ww, Gll^Fp, Gll, Gll^Fp, Gll^Fp, Gll^Fp, Gll, Gll^Fmf, Gll^Fdf, Gll^Fp, Isa^Es, Isa^Es, Isa, Isa, Isa, Isa^Es, Isa^Es, Gll^Fp, Gll^Fp, Gll^Fp, Gll^Fp, Gll^Fp, Gll^Fp, Gll^Fp, Gd^Fetd, Gd^Fetd, Gll^Fp, Gg
Gll^Fp, Gll^Fp, Gll^Fdf, Gll^Fp, Gll^Fp, Gll^Fp, Gll^Fp, Gll^Fmf, Gll^Fp, Rrc, Rb, Rb, Rb, Rb, Isa^Es, Isa^Es, Isa^Es, Isa^Es, Ch, Kh, Gll, Gll, Gll^Fmf, Gll^Fmf, Gll^Fp, Gll^Fp, Gll^Fp, Ss, Ss, Isa^Es, Isa^Es, Isa^Es, Isa^Es, Isa^Es, Ww^Bw\, Ss, Ss, Ss, Rrc^Vhr, Sm, Ss, Ss, Gll^Fdw, Gll^Fp, Gll^Fdw, Gg
Gll^Fp, Gll^Fmf, Gll^Fmf, Gll^Fp, Gll^Fp, Gll^Fp, Gll^Fp, Gll^Fp, Rrc, Isa^Es, Rrc, Rb, Rb, Isa^Es, Isa^Es, Isa, Isa, Isa, Isa^Es, Isa^Es, Gll^Fmf, Gll^Fp, Gll^Fp, Gll^Fp, Gll^Fmf, Gll^Fdf, Gll^Fp, Ss, Ss, Ww^Bw|, Isa^Es, Isa^Es, Isa, Isa, Isa, Sm, Ss, Sm, Sm, Ss, Ss, Ss, Gll^Fdw, Gll^Fp, Gll^Fdw, Gg
Gll^Fp, Gll^Fp, Gll^Fp, Gll, Gll^Fp, Gll^Fp, Gll, Gll^Fp, Gll^Fmf, Rrc, Re, Re, Rb, Xos, Xos, Isa, Isa^Ebn, Isa, Xos, Xos, Qxua, Gll^Fp, Gll^Fp, Gll^Fp, Gll, Gll^Fp, Gll^Fp, Sm, Ss, Sm, Ss, Sm, Isa, Isa^Eb, Isa, Ss, Ss, Ss, Ss, Sm, Ss, Ss, Gll^Fp, Gll^Fdw, Gll^Fdw, Gg
Gll^Fp, Gll^Fp, Gll^Fp, Gll^Fp, Gll^Fetd, Gll^Fp, Gll^Fp, Gll^Fp, Gll^Fp, Re, Re, Re, Re, Qxua, Qxua, Xos, Xos, Xos, Qxua, Qxua, Gll^Fp, Rrc, Gll^Fp, Gll, Gll^Fp, Gll^Fp, Gll^Fp, Ss, Isa, Isa, Isa, Ss, Isa, Isa, Isa, Ss, Sm, Ss, Sm, Sm, Ss, Sm, Gll^Fp, Gll^Fp, Gll^Fdw, Gg
Gll, Gll, Gll^Fp, Gll, Gll^Fdf, Gll^Fp, Gll, Gll^Fp, Rb, Rb, Rb, Re, Re, Ww, Isa^Es, Qxua, Qxua, Qxua, Isa^Es, Rb, Rrc, Isa^Es, Rrc, Gll, Gll^Fp, Gll^Fp, Gll^Fp, Ss, Isa, Isa^Eb, Ww, Isa^Ebn, Ww, Ss, Sm, Ss, Re, Isa, Isa, Ss, Sm, Sm, Gll^Fp, Gll^Fp, Gll^Fdw, Gg
Hh, Hh, Gll^Fp, Gll^Fp, Gll^Fp, Gll^Fmf, Gll^Fp, Re, Rb, Rb, Rb, Rb, Ww, Rrc^Pr/o, Rr, Rr, Isa, Isa^Es, Rb, Rb, Rb, Rb, Gll^Fmf, Gll^Fmf, Gll^Fmf, Gll^Fp, Gll^Fp, Sm, Isa, Isa, Ww, Ww, Ww, Ss, Sm, Ss, Isa, Isa^Eb, Gll^Fdw, Ss, Sm, Sm, Gll^Fp, Gll^Fp, Gll^Fdw, Gg
Rb, Gg, Rb, Gg, Rb, Gg, Rb, Gg, Rb, Rb, Rb, Rb, Rb, Rr, Gg, Rr, Isa, Ww, Ww, Ww, Ww, Rb, Gg, Gg, Gll^Fdf, Isa, Gll^Fdf, Isa, Isa, Ww, Ww, Ww, Gg, Gg, Gg, Gg, Gg, Gg, Gll^Fdw, Gll^Fdw, Gll^Fdw, Gll^Fp, Gll^Fdw, Gll^Fdw, Gll^Fdw, Gll^Fdw
Gg, Rb, Rb, Rb, Rb, Rb, Rb, Rb, Rb, Rb, Rb, Rb, Gg, Gg, Gg, Isa, Ch, Ch, Ch, Gg, Gg, Gg, Isa, Isa, Gll^Fdf, Gll^Fdf, Gg, Gg, Gll^Fdf, Gll^Fdf, Ww, Ww, Gg, Gg, Gg, Gg, Gg, Gg, Gg, Gll^Fdw, Gll^Fdw, Gll^Fdw, Hh, Hh, Hh, Gg
Gg, Gg, Gg, Gg, Gg, Gg, Rb, Rb, Gg, Rb, Gg, Gg, Gg, Gg, Gg, Gg, Ch, Ch, Kh, Ch, Isa, Isa, Isa, Isa, Gll^Fdf, Gll^Fdf, Gg, Gg, Gg, Gll^Fdf, Gg, Gg, Gg, Gg, Gg, Gg, Gg, Gg, Gg, Gg, Gg, Gg, Hh, Hh, Hh, Hh
Gg, Gg, Gg, Gg, Rb, Rb, Gg, Gg, Gg, Gg, Gg, Gg, Gg, Gg, Gg, Gg, Gg, Ch, Ch, Ch, Gg, Isa, Gg, Gg, Gll^Fdf, Gll^Fdf, Gg, Gg, Gg, Gg, Gg, Gg, Gg, Gg, Gg, Gg, Gg, Gg, Gg, Gg, Hh, Hh, Hh, Hh, Hh, Hh
Gg, Rb, Rb, Rb, Gg, Gg, Gg, Gg, Gg, Gg, Gg, Gg, Gg, Gg, Gg, Gg, Gg, Gg, Gg, Gg, Gg, Gg, Gg, Gg, Gg, Gg, Gg, Gg, Gg, Gg, Gg, Gg, Gg, Gg, Gg, Gg, Gg, Gg, Gg, Gg, Gg, Hh, Gg, Hh, Gg, Gg
